# level_04 群岛海战  ( . 平地  # 山地  ~ 水域 )
20 16 20
~~~~~~~~~~~~~~~~~~~~
~~~~~~~~~~~~~~~~~~~~
~~~~..~~~~~~~~~~~~~~
~~~~..~~~~~~##~~~~~~
~~~~~~~~~~~~##~~~~~~
~~~~~~~~~~~~~~~~~~~~
~~~~~~~~~~~~~~~~~~~~
~~~~~~~~.....~~~~~~~
~~~~~~~~.....~~~~~~~
~~~~~~~~~~~~~~~~~~~~
~~~~~~~~~~~~~~~~~~~~
~~~~~~##~~~~~~~~~~~~
~~~~~~##~~~~~~~~~~~~
~~~~~~~~~~~~~~....~~
~~~~~~~~~~~~~~....~~
~~~~~~~~~~~~~~~~~~~~
