# level_05 全域决战 ( . 草  , 泥  # 山  s 沙  _ 浅水  ~ 水  = 深水 )  北陆南海，四域合成对抗
60 44 20
[terrain]
............................###.............................
............................###.............................
....................,,,,,,,,###,,,,,,,,,,...................
....................,,,,,,,,###,,,,,,,,,,...................
....................,,,,,,,,###,,,,,,,,,,...................
....................,,,,,,,,###,,,,,,,,,,...................
....................,,,,,,,,,,,,,,,,,,,,,...................
....................,,,,,,,,,,,,,,,,,,,,,...................
....................,,,,,,,,,,,,,,,,,,,,,...................
....................,,,,,,,,,,,,,,,,,,,,,...................
....................,,,,,,,,###,,,,,,,,,,...................
....................,,,,,,,,###,,,,,,,,,,...................
....................,,,,,,,,###,,,,,,,,,,...................
....................,,,,,,,,###,,,,,,,,,,...................
....................,,,,,,,,###,,,,,,,,,,...................
....................,,,,,,,,###,,,,,,,,,,...................
....................,,,,,,,,,,,,,,,,,,,,,...................
....................,,,,,,,,,,,,,,,,,,,,,...................
....................,,,,,,,,,,,,,,,,,,,,,...................
............................................................
............................................................
............................................................
ssssssssssssssssssssssssssssssssssssssssssssssssssssssssssss
ssssssssssssssssssssssssssssssssssssssssssssssssssssssssssss
____________________________________________________________
____________________________________________________________
~~~~~~~~~~~~~~~~~~~~~~~~~~~~~~~~~~~~~~~~~~~~~~~~~~~~~~~~~~~~
~~~~~~~~~~~~~~~~~~~~~~~~~~~~~~~~~~~~~~~~~~~~~~~~~~~~~~~~~~~~
~~~~~~~~~~~~~~~~~~~~~~~~~~~~~~~~~~~~~~~~~~~~~~~~~~~~~~~~~~~~
~~~~~~~~~~~~~~~~~~=========================~~~~~~~~~~~~~~~~~
~~~~~~~~~~~~~~~~~~=========================~~~~~~~~~~~~~~~~~
~~~~~~~~~~~~~~~~~~=========================~~~~~~~~~~~~~~~~~
~~~~~~~~~~~~~~~~~~=========================~~~~~~~~~~~~~~~~~
~~~~~~~~~~~~~~~~~~===========s#s===========~~~~~~~~~~~~~~~~~
~~~~~~~~~~~~~~~~~~===========##s===========~~~~~~~~~~~~~~~~~
~~~~~~~~~~~~~~~~~~===========sss===========~~~~~~~~~~~~~~~~~
~~~~~~~~~~~~~~~~~~=========================~~~~~~~~~~~~~~~~~
~~~~~~~~~~~~~~~~~~=========================~~~~~~~~~~~~~~~~~
~~~~~~~~~~~~~~~~~~=========================~~~~~~~~~~~~~~~~~
~~~~~~~~~~~~~~~~~~=========================~~~~~~~~~~~~~~~~~
~~~~~~~~~~~~~~~~~~=========================~~~~~~~~~~~~~~~~~
~~~~~~~~~~~~~~~~~~=========================~~~~~~~~~~~~~~~~~
~~~~~~~~~~~~~~~~~~=========================~~~~~~~~~~~~~~~~~
~~~~~~~~~~~~~~~~~~=========================~~~~~~~~~~~~~~~~~
[decoration]
............................................................
............................................................
............................................................
.................T.....T...................t.....t..........
..................T.....T...................t.....t.........
...................T.....T...................t.....t........
..FFFFFFFFFFFF......T...................t.....t.....t.......
...............T.....T...................t.....t............
................T.....T...................t.....t...........
.................T.....T...................t.....t..........
..................T.....T...................t.....t.........
...................T.....T...................t.....t........
....................T...................t.....t.....t.......
...............T.....T...................t.....t............
............................................................
............................................................
............................................................
............................................................
............................................................
............................................................
............................................................
............................................................
............................................................
............................................................
............................................................
............................................................
............................................................
............................................................
............................................................
............................................................
............................................................
............................................................
............................................................
............................................................
...............................R............................
.............................R..............................
............................................................
............................................................
............................................................
............................................................
............................................................
............................................................
............................................................
............................................................
[deploy]
XXXXXXXXXXXXXXXXXXXXXXXXXXXXXXXXXXXXXXXXXXXXXXXXXXXXXXXXXXXX
XXXXXXXXXXXXXXXXXXXXXXXXXXXXXXXXXXXXXXXXXXXXXXXXXXXXXXXXXXXX
X.............XXXXXXXXXXXXXXXXXXXXXXXXXXXXXXXXXXXXXXXXXXXXXX
X.............XXXXXXXXXXXXXXXXXXXXXXXXXXXXXXXXXXXXXXXXXXXXXX
X.............XXXXXXXXXXXXXXXXXXXXXXXXXXXXXXXXXXXXXXXXXXXXXX
X.............XXXXXXXXXXXXXXXXXXXXXXXXXXXXXXXXXXXXXXXXXXXXXX
X.............XXXXXXXXXXXXXXXXXXXXXXXXXXXXXXXXXXXXXXXXXXXXXX
X.............XXXXXXXXXXXXXXXXXXXXXXXXXXXXXXXXXXXXXXXXXXXXXX
X.............XXXXXXXXXXXXXXXXXXXXXXXXXXXXXXXXXXXXXXXXXXXXXX
X.............XXXXXXXXXXXXXXXXXXXXXXXXXXXXXXXXXXXXXXXXXXXXXX
X.............XXXXXXXXXXXXXXXXXXXXXXXXXXXXXXXXXXXXXXXXXXXXXX
X.............XXXXXXXXXXXXXXXXXXXXXXXXXXXXXXXXXXXXXXXXXXXXXX
X.............XXXXXXXXXXXXXXXXXXXXXXXXXXXXXXXXXXXXXXXXXXXXXX
X.............XXXXXXXXXXXXXXXXXXXXXXXXXXXXXXXXXXXXXXXXXXXXXX
X.............XXXXXXXXXXXXXXXXXXXXXXXXXXXXXXXXXXXXXXXXXXXXXX
X.............XXXXXXXXXXXXXXXXXXXXXXXXXXXXXXXXXXXXXXXXXXXXXX
X.............XXXXXXXXXXXXXXXXXXXXXXXXXXXXXXXXXXXXXXXXXXXXXX
X.............XXXXXXXXXXXXXXXXXXXXXXXXXXXXXXXXXXXXXXXXXXXXXX
X.............XXXXXXXXXXXXXXXXXXXXXXXXXXXXXXXXXXXXXXXXXXXXXX
X.............XXXXXXXXXXXXXXXXXXXXXXXXXXXXXXXXXXXXXXXXXXXXXX
X.............XXXXXXXXXXXXXXXXXXXXXXXXXXXXXXXXXXXXXXXXXXXXXX
XXXXXXXXXXXXXXXXXXXXXXXXXXXXXXXXXXXXXXXXXXXXXXXXXXXXXXXXXXXX
XXXXXXXXXXXXXXXXXXXXXXXXXXXXXXXXXXXXXXXXXXXXXXXXXXXXXXXXXXXX
XXXXXXXXXXXXXXXXXXXXXXXXXXXXXXXXXXXXXXXXXXXXXXXXXXXXXXXXXXXX
XXXXXXXXXXXXXXXXXXXXXXXXXXXXXXXXXXXXXXXXXXXXXXXXXXXXXXXXXXXX
XXXXXXXXXXXXXXXXXXXXXXXXXXXXXXXXXXXXXXXXXXXXXXXXXXXXXXXXXXXX
XXXXXXXXXXXXXXXXXXXXXXXXXXXXXXXXXXXXXXXXXXXXXXXXXXXXXXXXXXXX
XXXXXXXXXXXXXXXXXXXXXXXXXXXXXXXXXXXXXXXXXXXXXXXXXXXXXXXXXXXX
X.............XXXXXXXXXXXXXXXXXXXXXXXXXXXXXXXXXXXXXXXXXXXXXX
X.............XXXXXXXXXXXXXXXXXXXXXXXXXXXXXXXXXXXXXXXXXXXXXX
X.............XXXXXXXXXXXXXXXXXXXXXXXXXXXXXXXXXXXXXXXXXXXXXX
X.............XXXXXXXXXXXXXXXXXXXXXXXXXXXXXXXXXXXXXXXXXXXXXX
X.............XXXXXXXXXXXXXXXXXXXXXXXXXXXXXXXXXXXXXXXXXXXXXX
X.............XXXXXXXXXXXXXXXXXXXXXXXXXXXXXXXXXXXXXXXXXXXXXX
X.............XXXXXXXXXXXXXXXXXXXXXXXXXXXXXXXXXXXXXXXXXXXXXX
X.............XXXXXXXXXXXXXXXXXXXXXXXXXXXXXXXXXXXXXXXXXXXXXX
X.............XXXXXXXXXXXXXXXXXXXXXXXXXXXXXXXXXXXXXXXXXXXXXX
X.............XXXXXXXXXXXXXXXXXXXXXXXXXXXXXXXXXXXXXXXXXXXXXX
X.............XXXXXXXXXXXXXXXXXXXXXXXXXXXXXXXXXXXXXXXXXXXXXX
X.............XXXXXXXXXXXXXXXXXXXXXXXXXXXXXXXXXXXXXXXXXXXXXX
X.............XXXXXXXXXXXXXXXXXXXXXXXXXXXXXXXXXXXXXXXXXXXXXX
X.............XXXXXXXXXXXXXXXXXXXXXXXXXXXXXXXXXXXXXXXXXXXXXX
XXXXXXXXXXXXXXXXXXXXXXXXXXXXXXXXXXXXXXXXXXXXXXXXXXXXXXXXXXXX
XXXXXXXXXXXXXXXXXXXXXXXXXXXXXXXXXXXXXXXXXXXXXXXXXXXXXXXXXXXX
