# level_07 地图测试 ( . 平地  , 泥地  s 沙地  # 山地  _ 浅水  ~ 水域  = 深水 )
40 24 20
[terrain]
........................................
........................................
.,,,,,,..........s_~===~_s....##..######
.,,,,,,..........s_~===~_s....##..######
.,,,,,,..........s_~===~_s........######
.................s_~===~_s..............
.................s_~===~_s..............
.................s_~===~_s..............
.................s_~===~_s..............
.................s_~===~_s..............
.............##..s_~===~_s..............
.............##..s_~===~_s..............
.............##..s_~===~_s..............
.................s_~===~_s..............
.................s_~===~_s..............
.................s_~===~_s..............
..________.......s_~===~_s..............
.._~~~~~~__________~===~_s..............
.._~~~~~~__________~===~_s..............
.._~~~~~~__________~===~_s..............
.._~~~~~~__________~===~_s..............
.._________________~===~_s..............
........................................
........................................
[decoration]
b.......................................
.........b.......R........b.............
.........................R..............
.......T.T.T...............b............
........T.T......R......................
.....T.T.TtT.............R..b...........
...bT.TtT.T..........................b..
....tT.T.T.Tb....R...........b..........
....T.T.T.Tt.............R............b.
.....T.TtT.T.b................b.........
.....b...........R.....................b
.........................R.....b........
......b.................................
...............b.R..............b.......
.......b.................R..T.T.T.......
................b..........T.T.T.b......
.................R..........T.T.T.......
b........................R.T.T.T..b.....
..........................b.T.T.T.......
.b...............R.........T.T.T...b....
..........b..............R..T.T.T.......
....................................b...
...........b.....R..........b...........
...b.....................R...........b..
[deploy]
...............XXXXXXXXXXXXXXXXXXXXXXXXX
...............XXXXXXXXXXXXXXXXXXXXXXXXX
...............XXXXXXXXXXXXXXXXXXXXXXXXX
...............XXXXXXXXXXXXXXXXXXXXXXXXX
...............XXXXXXXXXXXXXXXXXXXXXXXXX
...............XXXXXXXXXXXXXXXXXXXXXXXXX
...............XXXXXXXXXXXXXXXXXXXXXXXXX
...............XXXXXXXXXXXXXXXXXXXXXXXXX
...............XXXXXXXXXXXXXXXXXXXXXXXXX
...............XXXXXXXXXXXXXXXXXXXXXXXXX
...............XXXXXXXXXXXXXXXXXXXXXXXXX
...............XXXXXXXXXXXXXXXXXXXXXXXXX
...............XXXXXXXXXXXXXXXXXXXXXXXXX
...............XXXXXXXXXXXXXXXXXXXXXXXXX
...............XXXXXXXXXXXXXXXXXXXXXXXXX
...............XXXXXXXXXXXXXXXXXXXXXXXXX
...............XXXXXXXXXXXXXXXXXXXXXXXXX
...............XXXXXXXXXXXXXXXXXXXXXXXXX
...............XXXXXXXXXXXXXXXXXXXXXXXXX
...............XXXXXXXXXXXXXXXXXXXXXXXXX
...............XXXXXXXXXXXXXXXXXXXXXXXXX
...............XXXXXXXXXXXXXXXXXXXXXXXXX
...............XXXXXXXXXXXXXXXXXXXXXXXXX
...............XXXXXXXXXXXXXXXXXXXXXXXXX
