# level_05 立体攻防  ( . 平地  # 山地  ~ 水域 )
30 22 20
...............~~~~~~~~~~~~~~~
...............~~~~~~~~~~~~~~~
...####........~~~~~~~~~~~~~~~
...####........~~~~~~~~~~~~~~~
...............~~~~~~~~~~~~~~~
...............~~~~~~~~~~~~~~~
.........###...~~~~~~~~~~~~~~~
.........###...~~~~~~~~~~~~~~~
...............~~~~~~~~~~~~~~~
...............~~~~~~~~~~~~~~~
...............~~~~~~~~~~~~~~~
...............~~~~~~##~~~~~~~
...............~~~~~~##~~~~~~~
......##.......~~~~~~~~~~~~~~~
......##.......~~~~~~~~~~~~~~~
...............~~~~~~~~~~~~~~~
...............~~~~~~~~~~~~~~~
...............~~~~~~~~~~~~~~~
...............~~~~~~~~~~~~~~~
...............~~~~~~~~~~~~~~~
...............~~~~~~~~~~~~~~~
...............~~~~~~~~~~~~~~~
