# level_06 全域大会战  ( . 平地  # 山地  ~ 水域 )
44 32 20
......................~~~~~~~~~~~~~~~~~~~~~~
......................~~~~~~~~~~~~~~~~~~~~~~
....####..............~~~~~~~~~~~~~~~~~~~~~~
....####..............~~~~~~~~~~~~~~~~~~~~~~
......................~~~~~~##~~~~~~~~~~~~~~
......................~~~~~~##~~~~~~~~~~~~~~
......................~~~~~~~~~~~~~~~~~~~~~~
............####......~~~~~~~~~~~~~~~~~~~~~~
............####......~~~~~~~~~~~~~~....~~~~
......................~~~~~~~~~~~~~~....~~~~
......................~~~~~~~~~~~~~~~~~~~~~~
......................~~~~~~~~~~~~~~~~~~~~~~
........###...........~~~~~~~~~~~~~~~~~~~~~~
........###...........~~~##~~~~~~~~~~~~~~~~~
......................~~~##~~~~~~~~~~~~~~~~~
......................~~~~~~~~~~~~~~~~~~~~~~
......................~~~~~~~~~~~~~~~~~~~~~~
......................~~~~~~~~~~~~~~~~~~~~~~
....####..............~~~~~~~~~~~~~~~~~~~~~~
....####..............~~~~~~~~~~~~~~....~~~~
......................~~~~~~~~~~~~~~....~~~~
......................~~~~~~~~~~~~~~~~~~~~~~
......................~~~~~~~~~~~~~~~~~~~~~~
............####......~~~~~~~~~~~~~~~~~~~~~~
............####......~~~~~~##~~~~~~~~~~~~~~
......................~~~~~~##~~~~~~~~~~~~~~
......................~~~~~~~~~~~~~~~~~~~~~~
......................~~~~~~~~~~~~~~~~~~~~~~
......................~~~~~~~~~~~~~~~~~~~~~~
........###...........~~~~~~~~~~~~~~~~~~~~~~
......................~~~~~~~~~~~~~~~~~~~~~~
......................~~~~~~~~~~~~~~~~~~~~~~
