# level_04 深海猎杀 ( ~ 水  = 深水  _ 浅水  s 礁滩  # 礁石 )  反潜战：唯驱逐舰/潜艇可击水下
52 40 20
[terrain]
____~~~~~~~~~~~~~~=================~~~~~~~~~~~~~____
____~~~~~~~~~~~~~~=================~~~~~~~~~~~~~____
____~~~~~~~~~~~~~~=================~~~~~~~~~~~~~____
____~~~~~~~~~~~~~~=================~~~~~~~~~~~~~____
____~~~~~~~~~~~~~~=================~~~~~~~~~~~~~____
____~~~~~~~~~~~~~~=================~~~~~~~~~~~~~____
____~~~~~~~~~~~~~~=================~~~~~~~~~~~~~____
____~~~~~~~~~~~~~~=================~~~~~~~~~~~~~____
____~~~~~~~~~~s#s~=================~~~~~~~~~~~~~____
____~~~~~~~~~~##s~=================~~~~~~~~~~~~~____
____~~~~~~~~~~sss~=================~~~~~~~~~~~~~____
____~~~~~~~~~~~~~~=================~~~~~~~~~~~~~____
____~~~~~~~~~~~~~~=================~~~~~~~~~~~~~____
____~~~~~~~~~~~~~~=================~~~s#s~~~~~~~____
____~~~~~~~~~~~~~~=================~~~##s~~~~~~~____
____~~~~~~~~~~~~~~=================~~~sss~~~~~~~____
____~~~~~~~~~~~~~~=================~~~~~~~~~~~~~____
____~~~~~~~~~~~~~~=================~~~~~~~~~~~~~____
____~~~~~~~~~~~~~~=================~~~~~~~~~~~~~____
____~~~~~~~~~~~~~~=================~~~~~~~~~~~~~____
____~~~~~~~~~~~~~~=================~~~~~~~~~~~~~____
____~~~~~~~~~~~~~~=================~~~~~~~~~~~~~____
____~~~~~~~~~~~~~~=================~~~~~~~~~~~~~____
____~~~~~~~~~~~~~~=================~~~~~~~~~~~~~____
____~~~~~~~~~~~~~~=================~~~~~~~~~~~~~____
____~~~~~~~~~~~~~~=================~~~~~~~~~~~~~____
____~~~~~~~~~~~~~~=================~~~~~~~~~~~~~____
____~~~~~~~~~~~~~~=================~~~~~~~~~~~~~____
____~~~~~~~~~~~~~~=================~~~~~~~~~~~~~____
____~~~~~~~~~~~~~~=================~~~~~~~~~~~~~____
____~~~~~~~~~~~~~~========s#s======~~~~~~~~~~~~~____
____~~~~~~~~~~~~~~========##s======~~~~~~~~~~~~~____
____~~~~~~~~~~~~~~========sss======~~~~~~~~s#s~~____
____~~~~~~~~~~~~~~=================~~~~~~~~##s~~____
____~~~~~~~~~~~~~~=================~~~~~~~~sss~~____
____~~~~~~~~~~~~~~=================~~~~~~~~~~~~~____
____~~~~~~~~~~~~~~=================~~~~~~~~~~~~~____
____~~~~~~~~~~~~~~=================~~~~~~~~~~~~~____
____~~~~~~~~~~~~~~=================~~~~~~~~~~~~~____
____~~~~~~~~~~~~~~=================~~~~~~~~~~~~~____
[decoration]
....................................................
....................................................
....................................................
....................................................
....................................................
....................................................
....................................................
....................................................
....................................................
....................................................
..............R.....................................
....................................................
....................................................
........................................R...........
....................................................
.......................................R............
....................................................
....................................................
....................................................
....................................................
....................................................
....................................................
....................................................
....................................................
....................................................
....................................................
....................................................
....................................................
....................................................
....................................................
....................................................
....................................................
............................R..............R........
.............................................R......
....................................................
....................................................
....................................................
....................................................
....................................................
....................................................
[deploy]
.............XXXXXXXXXXXXXXXXXXXXXXXXXXXXXXXXXXXXXXX
.............XXXXXXXXXXXXXXXXXXXXXXXXXXXXXXXXXXXXXXX
.............XXXXXXXXXXXXXXXXXXXXXXXXXXXXXXXXXXXXXXX
.............XXXXXXXXXXXXXXXXXXXXXXXXXXXXXXXXXXXXXXX
.............XXXXXXXXXXXXXXXXXXXXXXXXXXXXXXXXXXXXXXX
.............XXXXXXXXXXXXXXXXXXXXXXXXXXXXXXXXXXXXXXX
.............XXXXXXXXXXXXXXXXXXXXXXXXXXXXXXXXXXXXXXX
.............XXXXXXXXXXXXXXXXXXXXXXXXXXXXXXXXXXXXXXX
.............XXXXXXXXXXXXXXXXXXXXXXXXXXXXXXXXXXXXXXX
.............XXXXXXXXXXXXXXXXXXXXXXXXXXXXXXXXXXXXXXX
.............XXXXXXXXXXXXXXXXXXXXXXXXXXXXXXXXXXXXXXX
.............XXXXXXXXXXXXXXXXXXXXXXXXXXXXXXXXXXXXXXX
.............XXXXXXXXXXXXXXXXXXXXXXXXXXXXXXXXXXXXXXX
.............XXXXXXXXXXXXXXXXXXXXXXXXXXXXXXXXXXXXXXX
.............XXXXXXXXXXXXXXXXXXXXXXXXXXXXXXXXXXXXXXX
.............XXXXXXXXXXXXXXXXXXXXXXXXXXXXXXXXXXXXXXX
.............XXXXXXXXXXXXXXXXXXXXXXXXXXXXXXXXXXXXXXX
.............XXXXXXXXXXXXXXXXXXXXXXXXXXXXXXXXXXXXXXX
.............XXXXXXXXXXXXXXXXXXXXXXXXXXXXXXXXXXXXXXX
.............XXXXXXXXXXXXXXXXXXXXXXXXXXXXXXXXXXXXXXX
.............XXXXXXXXXXXXXXXXXXXXXXXXXXXXXXXXXXXXXXX
.............XXXXXXXXXXXXXXXXXXXXXXXXXXXXXXXXXXXXXXX
.............XXXXXXXXXXXXXXXXXXXXXXXXXXXXXXXXXXXXXXX
.............XXXXXXXXXXXXXXXXXXXXXXXXXXXXXXXXXXXXXXX
.............XXXXXXXXXXXXXXXXXXXXXXXXXXXXXXXXXXXXXXX
.............XXXXXXXXXXXXXXXXXXXXXXXXXXXXXXXXXXXXXXX
.............XXXXXXXXXXXXXXXXXXXXXXXXXXXXXXXXXXXXXXX
.............XXXXXXXXXXXXXXXXXXXXXXXXXXXXXXXXXXXXXXX
.............XXXXXXXXXXXXXXXXXXXXXXXXXXXXXXXXXXXXXXX
.............XXXXXXXXXXXXXXXXXXXXXXXXXXXXXXXXXXXXXXX
.............XXXXXXXXXXXXXXXXXXXXXXXXXXXXXXXXXXXXXXX
.............XXXXXXXXXXXXXXXXXXXXXXXXXXXXXXXXXXXXXXX
.............XXXXXXXXXXXXXXXXXXXXXXXXXXXXXXXXXXXXXXX
.............XXXXXXXXXXXXXXXXXXXXXXXXXXXXXXXXXXXXXXX
.............XXXXXXXXXXXXXXXXXXXXXXXXXXXXXXXXXXXXXXX
.............XXXXXXXXXXXXXXXXXXXXXXXXXXXXXXXXXXXXXXX
.............XXXXXXXXXXXXXXXXXXXXXXXXXXXXXXXXXXXXXXX
.............XXXXXXXXXXXXXXXXXXXXXXXXXXXXXXXXXXXXXXX
.............XXXXXXXXXXXXXXXXXXXXXXXXXXXXXXXXXXXXXXX
.............XXXXXXXXXXXXXXXXXXXXXXXXXXXXXXXXXXXXXXX
