# level_02 空中突袭 ( . 草  , 泥  # 山  ~ 水  _ 浅水 )  我方仅空军，敌方地面装甲+空巡
56 40 20
[terrain]
......................####..._~~~_......................
......................####..._~~~_......................
......................####..._~~~_......................
......................####..._~~~_......................
......................####..._~~~_......................
......................####..._~~~_......................
......................####..._~~~_......................
......................####..._~~~_......................
............................._~~~_......................
............................._~~~_......................
............................._~~~_......................
............................._~~~_......................
......................####..._~~~_......................
......................####..._~~~_......................
......................####..._~~~_......................
......................####..._~~~_......................
......................####..._~~~_......................
......................####..._~~~_......................
......................####..._~~~_......................
......................####..._~~~_......................
......................####......_~~~_...................
......................####......_~~~_...................
......................####......_~~~_.......,,,,,,,,,,,.
......................####......_~~~_.......,,,,,,,,,,,.
......................####......_~~~_.......,,,,,,,,,,,.
......................####......_~~~_.......,,,,,,,,,,,.
................................_~~~_.......,,,,,,,,,,,.
................................_~~~_.......,,,,,,,,,,,.
................................_~~~_.......,,,,,,,,,,,.
................................_~~~_.......,,,,,,,,,,,.
......................####......_~~~_.......,,,,,,,,,,,.
......................####......_~~~_.......,,,,,,,,,,,.
......................####......_~~~_.......,,,,,,,,,,,.
......................####......_~~~_.......,,,,,,,,,,,.
......................####......_~~~_.......,,,,,,,,,,,.
......................####......_~~~_.......,,,,,,,,,,,.
......................####......_~~~_.......,,,,,,,,,,,.
......................####......_~~~_.......,,,,,,,,,,,.
......................####......_~~~_...................
......................####......_~~~_...................
[decoration]
........................................................
......F.................................................
..............................................T......T..
.F...........................................T......T...
..........F.................................T......T....
...........................................T......T.....
.....F....................................T......T......
..............F..........................T......T.......
........................................T......T......T.
.........F....................................T......T..
.............................................T......T...
....F.......................................T......T....
.............F.............................T......T.....
..........................................T......T......
........F................................T......T.......
........................................T......T......T.
...F..........................................T......T..
............F...........................................
........................................................
.......F................................................
........................................................
..F.....................................................
...........F................................t........t..
................................................t.......
......F....................................t........t...
...............................................t........
.F........................................t........t....
..........F...................................t.........
.........................................t........t.....
.....F.......................................t........t.
..............F.........................t........t......
............................................t........t..
.........F......................................t.......
...........................................t........t...
....F..........................................t........
.............F............................t........t....
..............................................t.........
........F................................t........t.....
........................................................
........................................................
[deploy]
...............XXXXXXXXXXXXXXXXXXXXXXXXXXXXXXXXXXXXXXXXX
...............XXXXXXXXXXXXXXXXXXXXXXXXXXXXXXXXXXXXXXXXX
...............XXXXXXXXXXXXXXXXXXXXXXXXXXXXXXXXXXXXXXXXX
...............XXXXXXXXXXXXXXXXXXXXXXXXXXXXXXXXXXXXXXXXX
...............XXXXXXXXXXXXXXXXXXXXXXXXXXXXXXXXXXXXXXXXX
...............XXXXXXXXXXXXXXXXXXXXXXXXXXXXXXXXXXXXXXXXX
...............XXXXXXXXXXXXXXXXXXXXXXXXXXXXXXXXXXXXXXXXX
...............XXXXXXXXXXXXXXXXXXXXXXXXXXXXXXXXXXXXXXXXX
...............XXXXXXXXXXXXXXXXXXXXXXXXXXXXXXXXXXXXXXXXX
...............XXXXXXXXXXXXXXXXXXXXXXXXXXXXXXXXXXXXXXXXX
...............XXXXXXXXXXXXXXXXXXXXXXXXXXXXXXXXXXXXXXXXX
...............XXXXXXXXXXXXXXXXXXXXXXXXXXXXXXXXXXXXXXXXX
...............XXXXXXXXXXXXXXXXXXXXXXXXXXXXXXXXXXXXXXXXX
...............XXXXXXXXXXXXXXXXXXXXXXXXXXXXXXXXXXXXXXXXX
...............XXXXXXXXXXXXXXXXXXXXXXXXXXXXXXXXXXXXXXXXX
...............XXXXXXXXXXXXXXXXXXXXXXXXXXXXXXXXXXXXXXXXX
...............XXXXXXXXXXXXXXXXXXXXXXXXXXXXXXXXXXXXXXXXX
...............XXXXXXXXXXXXXXXXXXXXXXXXXXXXXXXXXXXXXXXXX
...............XXXXXXXXXXXXXXXXXXXXXXXXXXXXXXXXXXXXXXXXX
...............XXXXXXXXXXXXXXXXXXXXXXXXXXXXXXXXXXXXXXXXX
...............XXXXXXXXXXXXXXXXXXXXXXXXXXXXXXXXXXXXXXXXX
...............XXXXXXXXXXXXXXXXXXXXXXXXXXXXXXXXXXXXXXXXX
...............XXXXXXXXXXXXXXXXXXXXXXXXXXXXXXXXXXXXXXXXX
...............XXXXXXXXXXXXXXXXXXXXXXXXXXXXXXXXXXXXXXXXX
...............XXXXXXXXXXXXXXXXXXXXXXXXXXXXXXXXXXXXXXXXX
...............XXXXXXXXXXXXXXXXXXXXXXXXXXXXXXXXXXXXXXXXX
...............XXXXXXXXXXXXXXXXXXXXXXXXXXXXXXXXXXXXXXXXX
...............XXXXXXXXXXXXXXXXXXXXXXXXXXXXXXXXXXXXXXXXX
...............XXXXXXXXXXXXXXXXXXXXXXXXXXXXXXXXXXXXXXXXX
...............XXXXXXXXXXXXXXXXXXXXXXXXXXXXXXXXXXXXXXXXX
...............XXXXXXXXXXXXXXXXXXXXXXXXXXXXXXXXXXXXXXXXX
...............XXXXXXXXXXXXXXXXXXXXXXXXXXXXXXXXXXXXXXXXX
...............XXXXXXXXXXXXXXXXXXXXXXXXXXXXXXXXXXXXXXXXX
...............XXXXXXXXXXXXXXXXXXXXXXXXXXXXXXXXXXXXXXXXX
...............XXXXXXXXXXXXXXXXXXXXXXXXXXXXXXXXXXXXXXXXX
...............XXXXXXXXXXXXXXXXXXXXXXXXXXXXXXXXXXXXXXXXX
...............XXXXXXXXXXXXXXXXXXXXXXXXXXXXXXXXXXXXXXXXX
...............XXXXXXXXXXXXXXXXXXXXXXXXXXXXXXXXXXXXXXXXX
...............XXXXXXXXXXXXXXXXXXXXXXXXXXXXXXXXXXXXXXXXX
...............XXXXXXXXXXXXXXXXXXXXXXXXXXXXXXXXXXXXXXXXX
