# level_03 抢滩登陆 ( = 深海  ~ 水  _ 浅水  s 沙滩  # 峭壁  , 泥 )  海军舰炮支援+狭窄滩头登陆
56 40 20
[terrain]
=======~~~~~~___###.....................................
=======~~~~~~___###.....................................
=======~~~~~~___###.....................................
=======~~~~~~___###.....................................
=======~~~~~~___###.....................................
=======~~~~~~___###.....................................
=======~~~~~~___###.....................................
=======~~~~~~___###.....................................
=======~~~~~~___###...........####......................
=======~~~~~~___###...........####......................
=======~~~~~~___###...........####......................
=======~~~~~~___###...........####......................
=======~~~~~~___###...........####......................
=======~~~~~~___###.....................................
=======~~~~~~___###.....,,,,,,,,,,,,,,,,,,,,,,,,,,,.....
=======~~~~~~___sssss...,,,,,,,,,,,,,,,,,,,,,,,,,,,.....
=======~~~~~~___sssss...,,,,,,,,,,,,,,,,,,,,,,,,,,,.....
=======~~~~~~___sssss...,,,,,,,,,,,,,,,,,,,,,,,,,,,.....
=======~~~~~~___sssss...,,,,,,,,,,,,,,,,,,,,,,,,,,,.....
=======~~~~~~___sssss...,,,,,,,,,,,,,,,,,,,,,,,,,,,.....
=======~~~~~~___sssss...,,,,,,,,,,,,,,,,,,,,,,,,,,,.....
=======~~~~~~___sssss...,,,,,,,,,,,,,,,,,,,,,,,,,,,.....
=======~~~~~~___sssss...,,,,,,,,,,,,,,####,,,,,,,,,.....
=======~~~~~~___sssss...,,,,,,,,,,,,,,####,,,,,,,,,.....
=======~~~~~~___sssss...,,,,,,,,,,,,,,####,,,,,,,,,.....
=======~~~~~~___###.....,,,,,,,,,,,,,,####,,,,,,,,,.....
=======~~~~~~___###.....,,,,,,,,,,,,,,####,,,,,,,,,.....
=======~~~~~~___###.....,,,,,,,,,,,,,,,,,,,,,,,,,,,.....
=======~~~~~~___###.....,,,,,,,,,,,,,,,,,,,,,,,,,,,.....
=======~~~~~~___###.....................................
=======~~~~~~___###.....................................
=======~~~~~~___###.....................................
=======~~~~~~___###.....................................
=======~~~~~~___###.....................................
=======~~~~~~___###.....................................
=======~~~~~~___###.....................................
=======~~~~~~___###.....................................
=======~~~~~~___###.....................................
=======~~~~~~___###.....................................
=======~~~~~~___###.....................................
[decoration]
........................................................
........................................................
........................T.......T.......T.......T.......
.........................T.......T.......T.......T......
..........................T.......T.......T.......T.....
...........................T.......T.......T.......T....
............................T.......T.......T.......T...
.............................T.......T.......T.......T..
......................T..........R....T.......T.......T.
.......................T...............T.......T........
........................T...............T.......T.......
.........................T....R..........T.......T......
..........................T....R..T.......T.......T.....
...........................T.......T.......T.......T....
........................................................
........................................................
........................................................
........................................................
........................................................
........................................................
........................................................
........................................................
.........................................R..............
........................................................
........................................................
......................................R.................
.......................................R................
........................................................
........................................................
..............................t........t........t.......
.........................t........t........t........t...
.............................t........t........t........
........................t........t........t........t....
............................t........t........t.........
.......................t........t........t........t.....
...........................t........t........t........t.
......................t........t........t........t......
..........................t........t........t........t..
..............................t........t........t.......
........................................................
[deploy]
.............XXXXXXXXXXXXXXXXXXXXXXXXXXXXXXXXXXXXXXXXXXX
.............XXXXXXXXXXXXXXXXXXXXXXXXXXXXXXXXXXXXXXXXXXX
.............XXXXXXXXXXXXXXXXXXXXXXXXXXXXXXXXXXXXXXXXXXX
.............XXXXXXXXXXXXXXXXXXXXXXXXXXXXXXXXXXXXXXXXXXX
.............XXXXXXXXXXXXXXXXXXXXXXXXXXXXXXXXXXXXXXXXXXX
.............XXXXXXXXXXXXXXXXXXXXXXXXXXXXXXXXXXXXXXXXXXX
.............XXXXXXXXXXXXXXXXXXXXXXXXXXXXXXXXXXXXXXXXXXX
.............XXXXXXXXXXXXXXXXXXXXXXXXXXXXXXXXXXXXXXXXXXX
.............XXXXXXXXXXXXXXXXXXXXXXXXXXXXXXXXXXXXXXXXXXX
.............XXXXXXXXXXXXXXXXXXXXXXXXXXXXXXXXXXXXXXXXXXX
.............XXXXXXXXXXXXXXXXXXXXXXXXXXXXXXXXXXXXXXXXXXX
.............XXXXXXXXXXXXXXXXXXXXXXXXXXXXXXXXXXXXXXXXXXX
.............XXXXXXXXXXXXXXXXXXXXXXXXXXXXXXXXXXXXXXXXXXX
.............XXXXXXXXXXXXXXXXXXXXXXXXXXXXXXXXXXXXXXXXXXX
.............XXXXXXXXXXXXXXXXXXXXXXXXXXXXXXXXXXXXXXXXXXX
.............XXX.....XXXXXXXXXXXXXXXXXXXXXXXXXXXXXXXXXXX
.............XXX.....XXXXXXXXXXXXXXXXXXXXXXXXXXXXXXXXXXX
.............XXX.....XXXXXXXXXXXXXXXXXXXXXXXXXXXXXXXXXXX
.............XXX.....XXXXXXXXXXXXXXXXXXXXXXXXXXXXXXXXXXX
.............XXX.....XXXXXXXXXXXXXXXXXXXXXXXXXXXXXXXXXXX
.............XXX.....XXXXXXXXXXXXXXXXXXXXXXXXXXXXXXXXXXX
.............XXX.....XXXXXXXXXXXXXXXXXXXXXXXXXXXXXXXXXXX
.............XXX.....XXXXXXXXXXXXXXXXXXXXXXXXXXXXXXXXXXX
.............XXX.....XXXXXXXXXXXXXXXXXXXXXXXXXXXXXXXXXXX
.............XXX.....XXXXXXXXXXXXXXXXXXXXXXXXXXXXXXXXXXX
.............XXXXXXXXXXXXXXXXXXXXXXXXXXXXXXXXXXXXXXXXXXX
.............XXXXXXXXXXXXXXXXXXXXXXXXXXXXXXXXXXXXXXXXXXX
.............XXXXXXXXXXXXXXXXXXXXXXXXXXXXXXXXXXXXXXXXXXX
.............XXXXXXXXXXXXXXXXXXXXXXXXXXXXXXXXXXXXXXXXXXX
.............XXXXXXXXXXXXXXXXXXXXXXXXXXXXXXXXXXXXXXXXXXX
.............XXXXXXXXXXXXXXXXXXXXXXXXXXXXXXXXXXXXXXXXXXX
.............XXXXXXXXXXXXXXXXXXXXXXXXXXXXXXXXXXXXXXXXXXX
.............XXXXXXXXXXXXXXXXXXXXXXXXXXXXXXXXXXXXXXXXXXX
.............XXXXXXXXXXXXXXXXXXXXXXXXXXXXXXXXXXXXXXXXXXX
.............XXXXXXXXXXXXXXXXXXXXXXXXXXXXXXXXXXXXXXXXXXX
.............XXXXXXXXXXXXXXXXXXXXXXXXXXXXXXXXXXXXXXXXXXX
.............XXXXXXXXXXXXXXXXXXXXXXXXXXXXXXXXXXXXXXXXXXX
.............XXXXXXXXXXXXXXXXXXXXXXXXXXXXXXXXXXXXXXXXXXX
.............XXXXXXXXXXXXXXXXXXXXXXXXXXXXXXXXXXXXXXXXXXX
.............XXXXXXXXXXXXXXXXXXXXXXXXXXXXXXXXXXXXXXXXXXX
