# level_01 海陆遭遇战  ( . 平地  # 山地  ~ 水域 )
30 20 20
..............~~~~~~~~~~~~~~~~
..............~~~~~~~~~~~~~~~~
....###.......~~~~~~~~~~~~~~~~
....###.......~~~~~~~~~~~~~~~~
....###.......~~~~~~~~~~~~~~~~
..............~~~~~~~~~~~~~~~~
..............~~~~~~~~~~~~~~~~
.........####.~~~~~~~~~~~~~~~~
.........####.~~~~~~~~~~~~~~~~
..............~~~~~~~~~~~~~~~~
..............~~~~~~~~~~~~~~~~
..............~~~~~~~~~~~~~~~~
....##........~~~~~~~~~~~~~~~~
....##........~~~~~~~~~~~~~~~~
..............~~~~~~~~~~~~~~~~
..............~~~~~~~~~~~~~~~~
..............~~~~~~~~~~~~~~~~
..............~~~~~~~~~~~~~~~~
..............~~~~~~~~~~~~~~~~
..............~~~~~~~~~~~~~~~~
