# level_02 微型遭遇战  ( . 平地  # 山地  ~ 水域 )
12 10 20
............
............
....##......
....##......
............
............
......##....
......##....
............
............
