# level_03 山地陆战  ( . 平地  # 山地  ~ 水域 )
18 14 20
..................
..................
...####.....###...
...####.....###...
..................
.......####.......
.......####.......
..................
...###.....####...
...###.....####...
..................
..................
..................
..................
